XXXXXXXXXXXXXXXXXXXXXXXXXXXXXXXXXXXXXXXXXXXXXXXXXXXXXXXXXXXXXXXXXXXXXXXXXXXXXXXXXXXXXXXXXXXXXXXXXXXXXXXXXXXXXXXXXXXXXXXXXXXXXXXXXXXXXXXXXXXXXXXXXXXXXXXXXXXXXXXXXXXXXXXXXXXXXXXXXXXXXXXXXXXXXXXXXXXXXXXXXXXXXXXXXXXXXXXXXXXXXXXXXXXXXXXXXXXXXXXXXXXXXXXXXXXXXXXXXXXXXXXXXXXXXXXXXXXXXXXXXXXXXXXXXXXXXXXXXXXXX
P   X                 X                         X         X   X     X       X     X     X         X       X           X         X       X   X                             X     X               X       X         X     X         X         X     X       X   X     X             X   X         X   X       X
X XXX XXXXXXXXXXX XXX X XXXXXXXXXXX XXXXX XXXXX XXXXX XXX X XXX XXX X X XXXXX X X X X X X XXXXXXX X XXXXX X XXXXXXX X X XXX XXX XXX XXX X X X XXXXXXXXX XXXXXXXXXXX XXXXX X X XXX X XXXXXXXXXXX X X XXX X X XXXXX X XXX X XXXXX X XXX XXXXX X XXXXX XXX XXX X X XXX X XXXXX X XXX X X XXXXXXX X X X XXX X X X
X     X       X   X   X X X   X   X     X X         X X X   X   X X   X     X X X X X X X   X   X   X   X X       X X X   X   X     X X   X X X   X   X X         X   X   X X     X X   X   X   X X   X X X     X X   X     X   X     X     X   X   X X X   X     X X X   X X   X   X       X X   X   X X X X
X XXXXX XXXXX X XXX XXX X X X X X XXX XXX X XXXXXXX X X X XXX XXX XXXXXXXXX X X XXX X XXXXX X XXXXXXX X X XXXXXXX X XXXXX XXX XXXXXXX XXXXX X XXX X X X X XXXXXXX XXX X XXXXXXXXXXX X X X X X XXXXXXX X XXX XXX XXXXX XXXXXXX XXXXXXXXX XXXXXXX X XXX X X XXXXXXX X XXX X XXXXX XXXXXXXXXXX X XXXXXXX XXX X X
X X     X   X X X X   X X X X   X   X X   X   X   X X X   X   X     X       X X     X     X X X     X X X     X   X       X   X X         X X     X X X   X       X   X       X     X X   X X X     X X   X   X X   X   X     X   X   X     X   X     X X X X   X X     X     X   X       X X     X       X X
X X XXX X X XXX X XXX X X X XXXXXXX X X XXXXXXX X X X X XXX XXX XXX X X XXXXX XXXXXXXXXXX X X X X X XXX X XXXXX XXXXXXX XXX XXX X XXXXXXX X XXXXXXX X XXX XXXXX XXX XXXXXXXXX X XXXXXXX XXX X XXX X X XXX XXXXX X X XXX X XXXXX XXX X XXXXX X X XXXXX X X X X X XXXXXXX XXXXX X X X X XXX X XXXXX XXXXXXXXX X
X X   X X X     X X   X X X   X   X X X     X   X X   X   X   X X   X X X   X   X         X X   X X X   X       X     X X   X X   X       X       X X X   X   X X   X       X   X     X X X X     X X X   X     X X     X X     X   X     X   X   X   X   X X X       X X     X X X X X   X     X   X       X
X XXX X X XXXXXXX X XXX X XXX X XXX X XXXXX X XXX XXXXXXX XXX X X X X X X X XXX X XXXXXXXXX XXXXX X X XXXXXXXXX X XXX XXX XXX X XXX XXXXX XXXXXXX X X XXXXX X XXX XXX X X XXXXXXX XXX X X X XXXXXXX X X XXX XXX X XXXXXXX XXXXX X XXXXXXX X XXXXXXX XXXXXXX X XXXXXXX XXX XXXXXXX X X X XXXXXXX XXX X XXXXXXX
X     X X X X     X X X   X   X X   X X   X     X X   X     X X X X X X X X   X X         X X   X X   X       X X   X   X X     X   X   X   X   X   X       X     X   X X X       X   X   X X     X   X X   X X X X     X   X   X X     X   X   X   X X     X   X   X     X     X X X X   X   X   X X X     X
XXXXXXX X X X X XXX X X XXX XXX X XXXXX X XXXXXXX X XXX XXXXX X X XXX XXX X XXX XXXXX XXX X X X X XXXXX XXXXX XXXXX XXX X XXXXX X XXX XXX XXX X XXXXXXXXXXXXXXXXXXX XXX XXX XXX XXX XXXXX X X XXX XXXXX X XXX X X XXXXX XXX X XXX X XXXXX XXX X X XXX X X XXXXX X X XXXXXXXXX X X X X XXX X X XXX X X XXXXX X
X     X X X   X     X   X   X           X         X       X   X X   X X   X     X   X   X X X X   X     X   X X   X X   X X   X X   X   X X   X   X       X         X X       X X X   X   X     X   X   X X     X     X   X X       X   X X   X X X     X     X   X     X     X   X X   X X X     X X     X X
XXX XXX X XXXXX XXXXXXXXX XXXXX XXXXXXXXXXX XXXXXXXXXXXXXXX XXX XXX X X XXXXXXXXX X XXX X X X X XXX XXXXX XXX X X X X XXX X X XXXXX X X X X XXXXX X XXX X X XXXXXXXXX XXXXXXXXX X XXX XXXXXXXXX X XXX XXX X XXXXXXXXX X XXX XXXXXXXXX X XXX XXX X XXXXXXXXXXX XXXXXXXXX X X XXXXXXX XXX XXX XXXXXXX XXXXX X X
X   X   X X   X X       X     X X X       X X       X       X   X X X   X     X   X X   X     X X   X   X   X   X   X     X X       X X   X X   X   X X X X     X   X   X       X   X X       X X X   X   X X     X   X   X     X   X X   X X   X             X X       X X X     X   X       X   X     X   X
X X X XXX X X X XXX XXX XXXXX X X X XXXXX XXX XXXXX X XXXXXXXXX X X XXXXX X X X XXX XXXXXXXXXXXXX XXX X XXX XXXXX XXXXXXXXX XXXXXXXXXXXXXXX X X XXXXX X X XXXXX X X X X X XXXXXXX XXX X XXXXX X X X XXX XXX X X XXX XXXXX XXXXX X X X XXX X X XXXXXXXXXXXXXXX X X XXXXXXX X X XXX XXXXXXXXXXX X XXX XXX XXXXX
X X X X X X X X X   X     X   X   X   X X   X X     X X       X   X       X X X   X               X   X     X     X   X                     X X   X   X X X   X X X   X X X     X       X     X X X X     X X X     X       X X X X X X   X X       X   X   X X X X       X   X X         X X X       X     X
X XXX X X X X X X X XXXXX X XXXXXXXXX X XXX X X XXXXX X X XXX XXXXX XXXXXXX XXXXX XXXXXXXXXXXXXXXXX X XXXXXXX XXXXX X X XXXXXXXXXXXXXXXXXXXXXXX XXX X X X X XXX XXX XXX X XXXXX X XXXXXXX XXXXXXX X XXXXX X X XXXXXXX XXXXX X X X X X X XXX XXXXX X X X X XXX X X X XXXXXXXXX X XXXXXXXXX X X X XXXXXXX XXX X
X X   X X   X X   X X   X X X       X     X   X     X X X X X     X X     X     X   X     X         X   X       X   X X X       X             X     X X X X   X   X X X X     X   X     X         X       X X     X   X X   X X X X X X   X   X   X X X X X   X   X   X     X         X   X X X   X   X   X X
X X XXX XXXXX XXXXXXX X X X X XXXXX XXXXX XXXXXXXXX X XXX X XXXXX X XXXXX XXXXX XXX X XXX XXXXX XXXXXXX X XXXXXXX XXX X XXXXX X X XXXXX XXXXX XXXXXXX X X XXX XXX X X X XXXXX XXXXX XXX XXXXXXXXX XXX XXXXXXXXXXX X XXX X XXX X X X X XXX XXX X XXX X X X X XXXXXXXXX X XXX XXXXXXXXXXX XXX X XXX X X X XXX X
X X X       X X       X X   X X     X   X   X       X     X     X X       X   X   X X   X X   X   X   X     X     X   X     X X X   X X X   X X       X X X     X X   X     X   X     X   X       X X X         X X   X   X   X   X X X X X   X   X   X X X   X       X X   X           X   X X   X X X X   X
X X XXXXX X X X XXXXXXX XXX X X XXXXX X XXX X XXXXX XXXXXXX XXX X XXX XXXXX X X X X XXX X X X XXX X X XXXXXXX XXXXX XXXXXXX X X XXX X X X X X X XXX XXX X X XXXXX XXX XXXXX XXX X XXXXX X X XXXXX X X X XXX XXX X XXX X XXX X XXXXX X X X X XXXXX XXXXX X XXX X XXXXXXX XXX X XXXXXXXXXXX X X X XXX X XXX XXX
X X       X X   X   X   X   X X       X   X X   X     X     X X   X X X     X   X X     X   X   X   X X       X   X X       X X     X X X X X X X   X   X X X   X   X X     X   X X   X X X X   X X X X   X   X X   X X     X     X   X X   X   X   X X X   X X       X   X X X     X     X X X X X X   X   X
X XXXXXXXXX XXXXXXX X XXXXXXX XXXXXXXXXXX X XXX XXXXXXX XXXXX XXXXX X X XXXXXXXXX XXXXXXXXXXXXX XXX XXX XXXXXXX X X X XXXXXXX XXXXX X X XXX X X X XXX XXX X X X XXX X X XXXXX XXX X X XXX X X X X X X XXX XXX XXXXX X XXXXXXX XXXXXXXXX XXXXXXX XXX X X XXX X XXXXXXXXXXX X X X XXXXX XXXXX X X X X XXX XXX X
X   X     X   X     X   X     X         X   X   X   X   X X           X X       X     X       X X   X   X   X   X X X X     X X   X   X   X     X X X X   X   X   X X X     X     X X     X X X X   X X X X X X     X     X   X             X   X X X     X X             X X X X     X     X X   X   X     X
X X X XXX XXX X X X XXX X XXXXXXXXX X XXXXXXX X X X X XXX X XXXXXXXXXXX X XXX XXXXXXX X XXXXXXX XXXXX XXXXX X XXX X X XXX X X X X XXX XXX XXXXXXX X X XXX XXXXXXX X X XXXXX XXXXXXX XXXXX XXX X XXXXX X X X X X XXXXX XXX XXXXX XXX XXXXXXX X X X X XXXXX X XXXXXXXXXXXXXXX X X X XXXXX XXXXX XXXXXXX XXXXX X
X X X   X     X X X X   X   X       X X       X X X   X         X   X   X X   X     X   X     X X     X   X X X     X X   X X X X   X   X     X     X   X         X X X   X     X X     X X   X         X X X   X   X   X     X   X     X     X   X   X   X         X     X X X       X     X X     X     X X
X XXXXX XXXXXXX X X X XXXXX X XXXXX XXX XXXXXXX X XXXXXXX XXXXXXX X X XXXXX X X X XXXXX X XXX X X XXXXX X X X XXXXXXX X XXX XXX XXX XXX XXXXX XXXXX XXX XXXXXXX XXX X XXX XXX X X XXXXX XXX XXXXXXXXXXXXX X XXXXX XXXXX XXXXX XXX XXXXX XXXXXXXXXXXXX X XXXXX XXX X X XXX X X X XXXXXXXXXXX X X XXX X XXX XXX
X     X     X   X X X     X X X   X X   X       X   X   X X X     X X X     X X X       X   X   X       X   X   X   X   X X X   X X X X     X     X X X   X     X   X     X X X       X     X     X     X X     X   X   X X   X   X     X       X   X X     X X   X X X   X   X   X       X X X   X X   X   X
X X X XXXXX XXXXX XXXXX XXX X X X XXX XXX XXXXXXXXX X X X X X XXXXX X X XXXXX X XXXXXXXXXXX XXXXXXX XXXXXXX XXX XXX XXXXX X X XXX X X XXXXX XXXXX X X XXX XXXXXXX XXXXXXX X X XXXXXXX XXXXXXX X XXX XXX X X X XXX X X XXX X X X XXX XXX X XXXXX X X X XXXXX XXX XXX X X XXXXXXXXX X XXXXX X X X X X XXXXXXX X
X X X   X   X   X     X X     X X     X   X X   X   X X X   X X     X X X     X X         X   X     X     X   X   X         X X   X X       X   X X   X   X       X         X X   X   X   X   X X   X X   X X     X   X   X X X X X X   X   X     X X X   X   X   X X X       X   X X       X X X X     X   X
X X XXX X XXX X XXX XXX X XXXXX XXXXXXX XXX X X X XXX X XXX X XXXXX X X XXXXX X XXXXX X XXXXX X XXXXX XXX XXXXXXX X XXXXXXX X X XXX X XXXXXXX XXX XXX X XXX XXXXXXX XXXXXXX X X X X XXX X X XXX X XXX XXXXX XXXXXXXXXXX X X XXX X X X XXXXX XXXXXXX X XXX XXX XXX X XXX XXX X X XXX XXXXXXX X XXX XXXXX X X X
X X   X X X   X   X   X X X X   X   X       X X X X   X X   X     X   X X   X X     X X     X   X   X   X         X X     X   X     X X       X   X   X   X   X     X     X X   X X   X X   X   X   X X   X X       X   X X       X X   X   X     X   X     X     X   X X   X X X X     X   X   X   X   X X X
X XXX XXX X XXXXX X X X X X X XXX X XXXXXXX X X X XXX X XXXXXXXXX XXXXX X X XXXXXXX X XXX X XXXXX X XXX XXX XXXXXXX X XXX XXXXX XXXXX XXXXX X X XXXXXXXXX XXX XXXXXXX XXX XXXXXXX XXX XXXXXXX XXXXX X X X X XXXXX X X XXX XXXXXXXXX XXX X XXX XXX XXXXX XXXXXXXXXXXXX XXX XXX X X XXXXX XXXXXXX X X XXX X X X
X X X     X X   X X X X X   X X   X   X   X X X X X   X         X X   X   X     X   X X   X X   X X   X   X X   X   X X X   X       X       X X X     X   X X   X     X     X     X X X   X   X     X   X X   X   X   X   X     X   X   X   X   X X   X             X   X X   X     X   X     X X X   X   X X
X X XXXXXXX X XXX X X X X XXX X XXXXX X XXX X X X X XXXXXXXXXXX X XXX X XXXXX X X XXX X XXX X X X X XXXXX XXX X X XXX X XXX XXXXXXX X XXXXXXX X X XXX X X X XXX X XXXXXXXXX X XXXXX X X X X XXX XXXXXXXXX XXX X XXXXXXX XXX XXXXX XXXXX XXX XXX X X X XXXXXXXXX XXX XXX X X XXXXXXX X X X X X X X XXX XXXXX X
X   X       X     X X X   X   X X     X     X X X X   X         X X   X     X X X   X X   X X X X X     X     X X   X X   X   X     X X     X X   X X X X   X   X X       X X X     X X X   X   X     X     X   X   X   X   X   X     X X X     X   X   X     X   X       X   X     X X X X X X X   X     X X
XXX X X XXXXX XXXXX X XXXXX XXX X XXXXXXXXXXX X X X X XXXXX XXXXX X XXXXX XXX XXXXX X XXX X XXX X XXXXX XXXXXXX XXXXX X X XXX X XXXXXXX XXX XXXXX X X X XXXXX XXX X XXXXX X X X X XXX X XXX X XXX XXX X XXXXX XXXXX X XXXXX X X X XXX X X XXXXXXXXXXXXX X XXX XXX XXXXXXXXXXXXX XXXXX XXX X X X XXXXXXXXX X X
X   X X X   X X   X X     X     X           X X X X X     X X     X     X X   X     X X   X   X X     X       X     X   X X   X         X X     X   X X     X X     X   X X   X X       X   X X   X   X X     X   X X X   X X X X X   X     X     X     X   X   X X     X       X   X     X X X         X X X
X XXXXX X X X X XXX XXX X XXXXXXXXXXXXXXXXX X X X X XXXXX X XXX XXX XXX X X XXX XXXXXXX XXXXX X XXXXX XXXXXXX XXXXX X XXXXX XXXXXXXXXXXXX XXXXX XXXXX XXXXX X X XXXXX X X XXXXX XXXXXXXXXXX X X XXX XXX X XXXXX X X X X X X X X X X X XXXXX X XXXXX XXX XXX XXX X XXX X X XXXXXXX XXXXXXXXX X XXXXXXXXX X X X
X       X X X X   X   X X     X     X     X   X X X X   X X     X     X   X   X   X     X X   X X   X   X   X     X X X     X       X     X             X   X X X     X   X   X   X       X X   X X X   X     X X X X X X   X X X X X X   X   X     X   X   X   X     X X X     X         X X     X     X X X
XXXXXXXXX XXX X X XXX X XXXXX X X X X XXX XXXXX X X X X X XXXXXXX XXXXXXXXXXX XXX X X XXX X XXX X X XXX X X X XXX X X X XXX X XXXXX X X XXX XXXXXXXXXXXXX X X X X XXXXXXX X X XXXXX XXXXX XXXXXXX X X X XXXXX X X X X X XXX X X X X XXX X XXX X XXXXXXXXX XXX XXXXXXX XXX XXX X XXXXX XXXXX XXXXXXX XXXXX XXX
X       X     X X     X X     X X X X   X X   X   X   X X     X X X           X X X X X X   X     X     X X X   X X   X X   X   X   X X X   X         X   X X X X       X X X     X X X   X       X X X     X X X X     X   X X X X   X X   X X X   X     X X X   X   X   X   X     X X   X       X     X   X
X XXX XXX XXXXX XXXXX X X XXXXXXX X XXX X XXX XXXXX XXXXX XXX X X X XXXXXXXXX X X XXX X X XXX XXXXXXXXXXX X XXX X XXXXX X XXXXX X XXX XXX XXX XXXXXXX X XXXXX XXXXX XXX X X XXXXX X X X XXX XXX X X X XXXXXXX X X XXXXXXXXXXX X X XXX X XXX X X X X X XXXXX X X X X XXX XXX XXXXXXX X X X XXXXXXX XXXXX X X X
X X X   X   X   X   X X X X       X X   X   X       X   X   X X   X X           X     X   X     X     X   X     X X   X X     X X   X     X X X     X X   X   X   X   X X X X     X X X   X   X X X X         X X   X         X X X   X   X X X   X   X     X X X X X   X       X   X   X     X     X   X X X
X X XXX XXX X XXX X X X X X XXXXXXX X XXXXX X XXXXXXX X XXXXX X XXX XXXXXXXXX XXXXXXXXX XXXXXXXXX XXX X XXXXXXXXX XXX X XXXXX X XXX XXXXX X X XXXXX X X X X XXX X XXXXX X X X XXX X X XXX XXX X XXX X XXXXXXXXX XXX X XXXXXXXXX XXX XXXXX X X XXXXXXXXX XXX X XXX X X XXXXXXX X X XXXXXXXXX X X XXXXX XXXXX X
X   X X   X X X   X X X X X X     X X X   X X X       X       X   X         X X       X X       X X X X X X     X     X X   X X   X     X   X       X X X       X       X X X   X X X   X   X X   X X       X   X X X X       X   X       X X     X       X X   X   X   X   X X X   X   X   X X X     X     X
XXX X XXX X XXX XXX XXX X X X XXXXX X X X X XXX XXXXXXXXXXXXXXXXX XXXXXXXXX XXX XXXXX X X XXXXX X X X X X X X XXXXXXX X X X XXXXX XXXXX XXXXXXXXXXX X XXXXXXXXXXXXXXXXXXXXX XXX XXX XXX XXX X XXX X XXXXXXXXX XXX X X X XXX XXXXX XXXXXXXXX XXXXX XXXXXXX X XXX XXXXXXX X X XXX XXX X X X XXX X X XXXXX XXX X
X       X       X       X   X         X X       X                         X         X     X       X     X   X         X   X           X             X                         X           X     X             X       X   X                 X             X   X           X     X     X   X   X         X   K
XXXXXXXXXXXXXXXXXXXXXXXXXXXXXXXXXXXXXXXXXXXXXXXXXXXXXXXXXXXXXXXXXXXXXXXXXXXXXXXXXXXXXXXXXXXXXXXXXXXXXXXXXXXXXXXXXXXXXXXXXXXXXXXXXXXXXXXXXXXXXXXXXXXXXXXXXXXXXXXXXXXXXXXXXXXXXXXXXXXXXXXXXXXXXXXXXXXXXXXXXXXXXXXXXXXXXXXXXXXXXXXXXXXXXXXXXXXXXXXXXXXXXXXXXXXXXXXXXXXXXXXXXXXXXXXXXXXXXXXXXXXXXXXXXXXXXXXXXXXXX
