XXXXXXXXXXXXX
P       X   X
X XXX X XXX X
X X X X     X
X X X XXXXX X
X X X X   X X
X X X X X XXX
X   X   X   X
XXX XXXXXXX X
X   X     X X
X XXX XXXXX X
X     X     K
XXXXXXXXXXXXX
