XXXXXXXXXXXXXXXXXXXXXXXXXXXXXXXXX
P             X     X           X
X XXXXXXXXXXX X XXXXX XXX XXXXX X
X       X X   X       X   X     X
X XXXXX X X XXXXXXXXXXX XXXXXXXXX
X X   X X X           X     X   X
XXX X X X X XXXXXXXXX X XXX X X X
X   X   X   X     X X X   X X X X
X X XXXXXXX X XXX X X XXXXX X X X
X X X     X X X   X   X   X   X X
X XXX XXX X X X XXXXX X X XXXXX X
X   X X X X X X X   X   X       X
X X X X X X X X X X XXXXXXXXXXX X
X X   X X X X X   X   X         X
X XXXXX X X X XXXXXXX X XXXXXXXXX
X       X X X X     X X   X     X
XXXXXXX X XXX XXXXX X XXX XXXXX X
X X   X X X   X   X X X         X
X X X X X X XXX X X X XXXXXXXXXXX
X   X X X   X   X X X X   X     X
X XXX X XXXXX XXX X X X X X XXX X
X X   X X     X X   X   X X   X X
X X XXX X X XXX XXX XXXXX XXXXX X
X X     X X X     X X X     X   X
X XXXXXXXXX X XXXXX X X XXXXX XXX
X X       X X X   X   X       X X
X X XXXXX X X X X XXX XXXXXXXXX X
X X X     X X   X   X X   X     X
X X XXX XXX XXX XXX X X X X XXX X
X X   X   X   X X X   X X   X   X
X XXX XXX XXX X X XXXXXXXXXXX X X
X     X       X               X K
XXXXXXXXXXXXXXXXXXXXXXXXXXXXXXXXX
